als	if
zijn	be
dat	that
hij	he
was	wax
voor	pro
op	up
met	with
ze	they
bij	with
een	an
hebben	have
deze	this
door	through
heet	hot
woord	word
maar	but
wat	what
sommige	some
is	is
het	the
u	you
of	whether
de	the
aan	on
en	and
in	in
we	we
kan	jug
uit	of
die	those
doen	do
hun	theirs
tijd	time
hoe	how
elk	everyone
vertellen	tell
set	set
drie	trey
willen	wish
lucht	sky
goed	well
ook	too
spelen	play
klein	small
thuis	home
lezen	read
poort	gate
toevoegen	add
zelfs	even
land	land
hier	here
moet	shall
hoog	high
volgen	follow
waarom	why
vragen	question
mannen	men
verandering	variation
ging	went
licht	light
soort	species
huis	house
afbeelding	image
proberen	try
ons	us
weer	weather
dier	animal
punt	point
moeder	mother
wereld	world
dichtbij	near
bouwen	construct
zelf	self
aarde	earth
vader	father
werk	work
deel	share
nemen	take
krijgen	receive
plaats	seat
gemaakt	phoney
wonen	live
waar	where
na	after
terug	back
weinig	little
alleen	only
ronde	round
man	man
jaar	year
kwam	came
elke	every
mij	me
geven	hand
onze	ours
onder	under
naam	name
zeer	very
gewoon	simply
vorm	shape
zin	sentence
denken	think
zeggen	say
helpen	help
laag	low
lijn	line
verschillen	vary
beurt	turn
oorzaak	reason
veel	much
betekenen	mean
verhuizing	move
jongen	lad
alle	all
wanneer	when
omhoog	upwards
gebruiken	utilize
uw	your
manier	way
over	over
dan	then
hen	them
schrijven	write
zou	would
zoals	like
dus	thus
haar	her
lang	tall
maken	tailor
ding	thing
zien	see
hem	him
twee	two
heeft	has
kijken	look
meer	more
dag	day
gaan	walk
komen	come
deed	did
aantal	quantity
klinken	sound
geen	no
meest	most
mensen	people
mijn	my
weten	know
water	water
roep	cry
eerste	prime
kant	way
nu	presently
vinden	find
hoofd	head
staan	stand
eigen	own
pagina	page
moeten	must
gevonden	found
antwoord	response
groeien	grow
studie	study
leren	learn
planten	plant
voedsel	food
zon	sun
vier	four
tussen	between
staat	state
houden	keep
oog	eye
nooit	never
laatste	last
laten	let
gedachte	thought
stad	town
boom	tree
oversteken	cross
boerderij	farm
hard	loudly
begin	start
verhaal	story
zaag	saw
ver	remote
zee	sea
tekenen	sketch
links	left
laat	late
lopen	walk
niet	not
terwijl	whilst
pers	press
dicht	thick
nacht	night
echt	wedlock
leven	live
noorden	north
boek	book
dragen	wear
wetenschap	science
kamer	room
vriend	friend
idee	thought
vis	fish
berg	mountain
stop	fuse
eenmaal	simply
paard	knight
gesneden	chopped
zeker	sure
kleur	colour
gezicht	sight
hout	wood
lijken	seem
samen	together
wit	white
kinderen	kids
beginnen	start
voorbeeld	model
gemak	leisure
papier	paper
groep	group
altijd	always
muziek	music
beide	both
vaak	often
brief	letter
tot	until
mijl	mile
rivier	river
auto	car
voeten	feet
zorg	worry
tweede	second
genoeg	sufficiently
meisje	girl
klaar	ready
boven	upstairs
ooit	once
rood	red
lijst	list
hoewel	though
voelen	feel
vogel	bird
spoedig	speedy
lichaam	body
hond	dog
familie	family
rechtstreeks	straight
pose	pose
vertrekken	leave
lied	song
meten	measure
deur	door
artikel	article
zwart	black
cijfer	number
klasse	class
wind	wind
vraag	question
gebeuren	occur
compleet	fully
schip	ship
gebied	territory
helft	half
rots	rock
brand	fire
zuiden	south
probleem	problem
stuk	piece
passeren	overtake
sinds	since
geheel	whole
straat	street
inch	inch
vermenigvuldigen	multiply
cursus	course
blijven	stay
wiel	wheel
kracht	strength
blauw	blue
object	object
beslissen	determine
maan	moon
eiland	island
voet	foot
systeem	system
toets	test
boot	boat
goud	gold
mogelijk	possibly
vliegtuig	plane
lachen	laugh
duizend	thousand
geleden	back
controleren	control
spel	play
gelijk	right
warmte	warmth
sneeuw	snow
band	tyre
brengen	take
ja	yes
vullen	fill
oosten	east
schilderen	paint
taal	language
eenheid	unity
vliegen	rush
vallen	traps
leiden	lead
huilen	weep
donker	darkness
apparaat	machine
noot	nut
wachten	wait
plannen	plan
ster	star
doos	box
veld	field
rest	rest
juist	right
pond	pound
gedaan	done
schoonheid	beauty
rijden	ride
stond	stood
bevatten	understand
voorzijde	front
week	week
finale	final
groen	green
snel	swift
ontwikkelen	develop
oceaan	ocean
gratis	gratis
minuut	minute
speciaal	special
geest	spirit
achter	behind
duidelijk	precise
staart	tail
produceren	produce
feit	fact
ruimte	space
best	best
uur	hour
beter	better
tijdens	during
honderd	hundred
vijf	five
onthouden	remember
stap	step
vroeg	early
grond	ground
rente	interest
bereiken	reach
werkwoord	verb
zingen	sing
luisteren	listen
zes	six
tafel	table
reizen	travel
minder	less
ochtend	morning
tien	ten
eenvoudig	simply
verscheidene	various
klinker	vowel
oorlog	war
tegen	against
patroon	sponsor
langzaam	slowly
centrum	centre
liefde	love
persoon	person
geld	money
dienen	serve
verschijnen	appear
weg	way
kaart	map
regen	rain
regel	rule
regeren	govern
trek	trait
koude	cold
stem	voice
energie	energy
waarschijnlijk	probably
bedden	beds
broer	brother
ei	egg
cel	cell
geloven	believe
misschien	perhaps
plotseling	sudden
tellen	count
reden	reason
lengte	length
vertegenwoordigen	represent
kunst	art
onderwerp	topic
regio	region
grootte	magnitude
variëren	vary
vestigen	establish
spreken	speak
gewicht	weight
algemeen	universal
ijs	ice
aangelegenheid	matter
cirkel	circle
paar	pair
omvatten	comprise
kloof	gorge
lettergreep	syllable
bal	sphere
hart	heart
aanwezig	present
zwaar	heavy
dans	dance
motor	motorbike
positie	position
arm	poor
breed	wide
zeil	sail
materiaal	material
fractie	fraction
bos	wood
zitten	sit
ras	race
venster	window
winkel	store
zomer	summer
trein	train
slaap	temple
bewijzen	prove
been	leg
oefening	exercise
muur	wall
vangst	catch
wensen	wishes
hemel	sky
boord	rim
vreugde	joy
zat	drunk
wild	wild
instrument	instrument
glas	glass
gras	grass
koe	cow
teken	sign
bezoek	visit
verleden	past
lol	fun
gas	gas
maand	month
miljoen	million
hopen	hope
bloem	flower
kleden	dress
vreemd	strange
handel	trade
melodie	tune
reis	voyage
kantoor	office
ontvangen	receive
rij	row
mond	mouth
symbool	symbol
sterven	die
problemen	problems
schreeuw	shout
behalve	except
schreef	wrote
zaad	sperm
toon	tone
suggereren	suggest
schoon	clean
dame	queen
stijgen	rise
slecht	wicked
klap	smack
olie	oil
bloed	blood
aanraken	touch
procent	percent
mengen	mix
draad	wire
kosten	cost
verloren	lost
bruin	brown
tuin	garden
kiezen	pick
passen	fit
eerlijk	honestly
bank	sofa
verzamelen	gather
besparen	spare
decimaal	decimal
oor	ear
anders	otherwise
heel	whole
brak	brackish
geval	instance
midden	midst
doden	kill
zoon	son
momenteel	current
schaal	scale
luid	loud
voorjaar	spring
waarnemen	perceive
kind	kid
medeklinker	consonant
natie	nation
woordenboek	dictionary
melk	milk
snelheid	speed
methode	method
orgel	organ
betalen	pay
leeftijd	age
kleding	wear
wolk	cloud
verrassing	surprise
rustig	tranquil
steen	stone
minuscuul	minuscule
klimmen	climb
ontwerp	design
onderzijde	underside
sleutel	key
ijzer	iron
stok	stick
flat	flat
twintig	twenty
huid	skin
glimlach	smile
vouw	fold
gat	hole
springen	spring
kindje	infant
acht	eight
dorp	village
ontmoeten	meet
wortel	root
kopen	purchase
verhogen	raise
metalen	metal
zeven	seven
paragraaf	paragraph
derde	third
beschrijven	describe
kok	cook
vloer	floor
ofwel	either
resultaat	result
verbranden	burn
veilig	sure
kat	cat
eeuw	century
overwegen	consider
wet	law
beetje	bit
kust	shore
kopie	copy
stil	still
zand	sand
bodem	soil
rol	part
temperatuur	temperature
vinger	finger
industrie	industry
waarde	worth
strijd	struggle
leugen	lie
verslaan	hammer
hoofdstad	capital
stoel	chair
gevaar	hazard
fruit	fruit
rijk	wealthy
soldaat	soldier
proces	process
werken	working
praktijk	practice
apart	unusual
moeilijk	hard
arts	doctor
beschermen	shelter
middag	noon
gewas	crop
onderdeel	subdivision
leerling	pupil
hoek	corner
partij	party
levering	delivery
karakter	character
insecten	insects
gevangen	caught
periode	period
atoom	atom
menselijk	human
geschiedenis	history
verwachten	expect
bot	bone
spoor	trail
bieden	offer
instemmen	agree
vrouw	woman
kapitein	master
noodzakelijk	necessary
vleugel	wing
creëren	create
buurman	neighbour
wassen	wax
vleermuis	bat
eerder	sooner
menigte	multitude
maïs	maize
vergelijken	compare
gedicht	poem
koord	rope
afhangen	depend
vlees	meat
wrijven	rub
buis	tube
stroom	current
angst	fear
zicht	sight
dun	thin
driehoek	triangle
planeet	planet
haast	nearly
kolonie	colony
klok	clock
stropdas	tie
voeren	feed
vers	verse
zoeken	seek
sturen	steer
geel	yellow
pistool	pistol
toelaten	permit
afdrukken	print
dood	death
plek	place
woestijn	desert
pak	suit
lift	lift
aankomen	arrive
meester	master
ouder	parent
oever	bank
divisie	league
blad	sheet
stof	material
gunst	favour
aansluiten	connect
post	mail
besteden	spend
akkoord	treaty
vet	greasy
blij	joyful
origineel	original
aandeel	share
station	station
brood	bread
rekenen	reckon
behoorlijk	significant
bar	rude
aanbod	offer
slaaf	slave
eend	duck
markt	mart
graad	grade
kuiken	chick
vijand	foe
antwoorden	answer
drankje	drink
voorkomen	prevent
ondersteuning	support
spraak	speech
natuur	nature
reeks	series
stoom	steam
beweging	movement
pad	trail
vloeistof	liquid
tanden	teeth
schelp	shell
nek	neck
zuurstof	oxygen
suiker	sugar
vrij	vacant
vaardigheid	skill
vrouwen	women
seizoen	season
oplossing	solution
magneet	magnet
zilver	silver
dank	thanks
tak	twig
wedstrijd	match
vooral	particularly
vijg	fig
bang	scared
reusachtig	stupendous
zus	sister
staal	steel
bespreken	discuss
vooruit	upfront
begeleiden	guide
ervaring	experience
appel	apple
gekocht	purchased
toonhoogte	pitch
massa	mass
touw	string
dromen	dream
avond	evening
voorwaarde	condition
voer	feed
gereedschap	tools
totaal	total
geur	smell
dal	valley
noch	neither
dubbel	double
blokkeren	block
grafiek	graph
hoed	hat
verkopen	sell
succes	success
bedrijf	plant
aftrekken	subtract
bijzonder	special
zwemmen	swim
termijn	term
schoen	shoe
schouder	shoulder
regelen	arrange
kamp	struggle
uitvinden	invent
katoen	cotton
geboren	born
bepalen	stipulate
negen	nine
vrachtwagen	van
niveau	level
kans	chance
gooien	toss
glans	gloss
pand	premises
column	column
molecuul	molecule
selecteren	select
mis	Mass
grijs	grey
vereisen	require
bereiden	prepare
zout	salt
neus	nose
meervoud	plural
woede	rage
werelddeel	continent
oksel	armpit